tag,num_bays_x,num_bays_y,stairs_grid_x,stairs_grid_y
B01,3,2,1,0
B02,5,2,2,0
B03,7,2,3,0
B04,3,3,1,0
B04b,3,3,1,1
B05,5,3,2,0
B06,7,3,3,0
B07,3,3,0,0
B08,3,4,0,0
B09,3,5,0,0
B10,3,6,0,0